Your syllabus asks you to "List 3 common words for each letter A-M" and "Explain the sound". Below is a list of words found in your source texts to help you fulfill this task. Use these to practice your pronunciation in the Lab phase.
• Α (a):
    1. Αθήνα (Athína) - Athens
    2. αγοράζω (agorázo) - to buy
    3. αρέσει (arési) - to like
• Β (v):
    1. βλέπω (vlépo) - to see/watch
    2. βιβλίο (vivlío) - book
    3. βάζω (vázo) - to put
• Γ (gh/y):
    1. γάλα (gála) - milk
    2. γράφω (gráfo) - to write
    3. γυναίκα (ginéka) - woman
• Δ (th as in then):
    1. δρόμος (drómos) - street
    2. δίνω (díno) - to give
    3. δουλεύω (doulévo) - to work
• Ε (e):
    1. εγώ (egó) - I
    2. ένα (éna) - one
    3. έρχομαι (érchome) - to come
• Ζ (z):
    1. ζώνη (zóni) - belt
    2. ζωή (zoí) - life
    3. ζάχαρη (záchari) - sugar
• Η (i):
    1. ημέρα (iméra) - day
    2. ήλιος (ílios) - sun
    3. ήρωας (íroas) - hero
• Θ (th as in thin):
    1. θέλω (thélo) - to want
    2. θάλασσα (thálassa) - sea
    3. θυμάμαι (thimáme) - to remember
• Ι (i):
    1. ιπποπόταμος (ipopótamos) - hippopotamus
    2. Ιταλία (Italía) - Italy
    3. ισπανικά (ispaniká) - Spanish
• Κ (k):
    1. κάνω (káno) - to do
    2. καφές (kafés) - coffee
    3. καλημέρα (kaliméra) - good morning
• Λ (l):
    1. λέω (léo) - to say
    2. λεμόνι (lemóni) - lemon
    3. λάθος (láthos) - mistake/wrong
• Μ (m):
    1. μαμά (mamá) - mom
    2. μένω (méno) - to live/stay
    3. μαθαίνω (mathéno) - to learn
